000001000000010000010000010000011111111101000000100001010000
011001111111011111010110110111010100000001001110100111011110
001000000000010010010010010000010101110001001000101100000000
001000010000010010011110110111110101010101001111100000011111
001001011111000010010000000000000000000101001000001111001000
501001010001001010010111111111111111111101001001101000101010
001001010000001000010000000000000100100000001010000011101010
111001011111111111010000111111100001101000001010111110001010
000000000000000000010100100000001100001001000010000010101010
000000001000000000000100101111111001111001000000000010101010
001111101111001100001100100000010011000001001001111110101010
001000001001001000000100111111010110000001001000000000111110
001000001001001011110100100000010100111001111000000000010000
001011111001001010010100101111110000100000000001111110010100
401000000001001010000100100000011111100000000000000010011100
001000000001001011110100111111000000111111111111111110010100
001111111110001000000100000000000000100000000000000000010100
000000000010011111001111111111111100101111111101011111010100
001111011011110001001000000000000100101000000101000001000100
001000001010010101001000000000000100101011110101111001000000
001111101010010101001001111111100100101010010100001001111111
001010001000010101001000000100100100101000010111001000000000
001011101111110101001001110100100100101111110100001000000000
001010000000000000000001000100101111100000000100001111001111
001000000000000000000001000100100000111111111100101001001001
001111101111111111001001011100101111100000000000101001001001
000000001000100001101001000000101000001111111100111001000001
111111101010101011001001111111101111111000010000000001111111
000000000010001001011000100000000000000000010000000000000001
